00000000000000000000000000000000000000000000
00000000000000000000000000000000000000000000
000hh000hh0000000000000000000000000000000000
000hh000hh0000000000000000000000000000000000
000hHrrrHh000ii00000000000000000000000000000
000000r000000ii00000000000000hh0000000000000
000hh0r0hh000iIrr000000000000hh0000000000000
000hh0r0hh000000r0000000000rrHh0000000000000
000hHrrrHh000000r0000000000r0000000000000000
000000r000000000r0000000000r0000000000000000
000000rrrrrrrrrrrrrrrrrrrrrrrrrrrr0000000000
000000r000000000000000r000000000000000000000
000000r00000000000www0r000000000000000000000
000000r00000000000wwWrr000000www000000000000
000000r000000000000000rrrrrrrWww000000000000
000000r00000000000000rr000000000000000000000
000000r00000000000000rr000000000000000000000
000000rrrrrrrrrrrrrrrrr0000www00000000000000
000000r000000000000rrrrrrrrWww00000000000000
000000r00000000000000r0000000000000000000000
00www0r00000000000000r0000000000000000000000
00wwWrr00000000000000r0000hh0000000000000000
000000000000000000000r0000hh0000000000000000
000000000000000000000rrrrrHh0000000000000000
00000000000000000000000000000000000000000000
00000000000000000000000000000000000000000000
00000000000000000000000000000000000000000000
00000000000000000000000000000000000000000000
00000000000000000000000000000000000000000000
00000000000000000000000000000000000000000000
