00000000000000000000000000000000000000000000
000hh000hh0000000000000000000000000000000000
000hh000hh0000000000000000000000000000000000
000hHrrrHh0000000000000000000000000000000000
000000r0000000000000000000000000000000000000
000hh0r0hh0000000000000000000000000000000000
000hh0r0hh0000000000000000000000000000000000
000hHrrrHh0000000000000000000000000000000000
000000r0000000000000000000000000000000000000
000000rrrrrrrrrrrrrrrrrrrrrrrrrrrr0000000000
000000r000000000000000r000000000000000000000
000000r00000000000www0r000000000000000000000
000000r00000000000wwWrr000000000000000000000
000000r000000000000000r000000000000000000000
000000r000000000000rrrr000000000000000000000
000000r000000000000rrrr000000000000000000000
000000rrrrrrrrrrrrrrrrr0000www00000000000000
000000r000000000000rrrrrrrrWww00000000000000
000000r0000000000000000000000000000000000000
00www0r0000000000000000000000000000000000000
00wwWrr0000000000000000000000000000000000000
00000000000000000000000000000000000000000000
00000000000000000000000000000000000000000000
00000000000000000000000000000000000000000000
00000000000000000000000000000000000000000000
00000000000000000000000000000000000000000000
00000000000000000000000000000000000000000000
00000000000000000000000000000000000000000000
00000000000000000000000000000000000000000000
00000000000000000000000000000000000000000000
