00000000000000000000000000000000000000000000
000hh000hh0000000000000www000000000000000000
000hh000hh0000000000000wwWrr0000000000000000
000hHrrrHh00000000000000000r0000000000000000
000000r00000000000000000000r0hh000000hh00000
000hh0r0hh00000000000000000r0hh000000hh00000
000hh0r0hh00000000000000000rrHh000000Hh00000
000hHrrrHh00000000000000000r000000000r000000
000000r00000000000000000000r000000000r000000
000000rrrrrrrrrrrrrrrrrrrrrrrrrrrrrrrr000000
000000r000000000000000r00000000000000r000000
000000r00000000000www0r00000000000000r000000
000000r00000000000wwWrr000000www00000r000000
000000r000000000000000rrrrrrrWww00000r000000
000000r000000000000000r00000000000000r000000
000000r000000000000000r00000000000000r000000
000000rrrrrrrrrrrrr000r0000www0000000r000000
000000r00000000000rrrrrrrrrWww0000000r000000
000000r00000000000000r000000000000000r000000
00www0r00000000000000rrrrrrrrrrrrrrrrr000000
00wwWrr00000000000000r00000hh00000000r000000
000000r00000000000000r00000hh00000000r000000
000000rrrrrrrrrrrrrrrrrrrrrHh00000000r000000
00000000000000r000000000000000000www0r000000
00000000000000r0000000hh000000000wwWrr000000
00000000000000r0000000hh00000000000000000000
00000000000000rrrrrrrrHh00000000000000000000
00000000000000000000000000000000000000000000
00000000000000000000000000000000000000000000
00000000000000000000000000000000000000000000
